1111111111111111111111111111111111
1E0000000000001C00000C000000000001
111001010010P011111001000000010101
101001001010101CCC1001000000010101
100000000C00C0000000000000000000C1
1111111111111111111111111111111111
